W W W W W W W W W W W W W
W - - - - - - - - - - - W
W - - - - R - - - R - - W
W - - R - - J - - - - - W
W - - - - - - - - - - - W
W - J - - - P - - - - - W
W - - - - - - - - - - - W
W - - - R - - - - - - - W
W - - R - - - - - - - - W
W - - - - - D - D - - - W
W - - - - - - - - - - - W
W W W W W W W W W W W W W