W W W W W W W W W W W W W
W - - - - - - - - - - - W
W - - - - R - - - R - - W
W - - R - - - - - - - - W
W - - - - - - - - - - - W
W - - - - - P - - - - - W
W - - - - - - - - - - - W
W - - - R - - - - - - - W
W - - R - - - - - - - - W
W - - - - - D - D - - - W
W - - - - - - - - - - - W
W W W W W W W W W W W W W