W W W W W W W W W W W W W
W D D R D D - D D D D P W
W D D D D D - D R D D D W
W D D D D - - - D D D D W
W D D R W W - W W R D D W
W D D D J D W D J D D D W
W D D W W W W W W W D D W
W D D D - D D D D D D D W
W W W R R R R R R R R D W
W E - J D D D D D D D - W
W D - D D D - D W W W D W
W W W W W W W W W W W W W