W W W W W W W W W W W W W
W D D R D D D - - - - - W
W D D D D R D D R D D D W
W J D R D J W D D D D D W
W - W W W W W - D D D D W
W E D D J D D D J D D D W
W D D D D W W W D D D D W
W W W D J D D D D D W W W
W D D D D D - D D D D D W
W D D R - - - - R D R D W
W P D D - - - - D D D J W
W W W W W W W W W W W W W