W W W W W W W W W W W W W
W D D R D D D D D D D E W
W D D J D D D D R D D D W
W D D R D - - - D D D J W
W D D D D D D D D D D D W
W D D D - - D D J D D D W
W D D R D D D D D D D D W
W D D D J D D D D D D D W
W D - - D D - D D D D D W
W D D R D D - - D D D D W
W D D D D D D D D D D P W
W W W W W W W W W W W W W